block ClickBlock 修改为: qClickBlockq
colorset AccentColor 修改为: eAccentColore
define BOLDSYSTEMFONT 修改为: Faeroese
define CurrentLanguage 修改为: zCurrentLanguagez
define CurrentSystemVersion 修改为: dCurrentSystemVersiond
define DLog 修改为: gDLogg
define DURATION_TIME 修改为: iDURATION_TIMEi
define FONT 修改为: rFONTr
define HasString 修改为: StimulateTrain
define HitoNavBarHeight 修改为: eHitoNavBarHeighte
define HitoSafeAreaHeight 修改为: lHitoSafeAreaHeightl
define HitoStatusBarHeight 修改为: yHitoStatusBarHeighty
define HitoTabBarHeight 修改为: dHitoTabBarHeightd
define Hong_h 修改为: TransitionHydrogen
define IMAGE_NAMED 修改为: oIMAGE_NAMEDo
define INTERSPACEPARAM 修改为: hINTERSPACEPARAMh
define IOSAVAILABLEVERSION 修改为: xIOSAVAILABLEVERSIONx
define ITTDPRINTMETHODNAME 修改为: Converting
define ImageWithFile 修改为: mImageWithFilem
define Iphone6ScaleHeight 修改为: tIphone6ScaleHeightt
define Iphone6ScaleWidth 修改为: yIphone6ScaleWidthy
define KBlackColor 修改为: eKBlackColore
define KBlueColor 修改为: nKBlueColorn
define KClearColor 修改为: KibibyteReadableDiscolour
define KGray2Color 修改为: lKGray2Colorl
define KGrayColor 修改为: ChiliadHoaryTinge
define KPostNotification 修改为: rKPostNotificationr
define KRedColor 修改为: gKRedColorg
define KScreenHeight 修改为: dKScreenHeightd
define KScreenWidth 修改为: KBShieldWidth
define KWhiteColor 修改为: GCleanDiscolour
define NSStringFormat 修改为: fNSStringFormatf
define PrefixHeader_pch 修改为: SuffixHeaderDecrypted
define PropertyFloat 修改为: oPropertyFloato
define PropertyLongLong 修改为: hPropertyLongLongh
define PropertyNSArray 修改为: tPropertyNSArrayt
define PropertyNSDictionary 修改为: iPropertyNSDictionaryi
define PropertyNSInteger 修改为: nPropertyNSIntegern
define PropertyNSMutableArray 修改为: BelongingsNChangeableAlign
define PropertyString 修改为: bPropertyStringb
define RGB 修改为: Introductory
define RGBA 修改为: bRGBAb
define SINGLETON_FOR_CLASS 修改为: vSINGLETON_FOR_CLASSv
define SINGLETON_FOR_HEADER 修改为: LoadingPlaneLintel
define SYSTEMFONT 修改为: Italic
define SafeStr 修改为: bSafeStrb
define StrValid 修改为: yStrValidy
define ValidArray 修改为: gValidArrayg
define ValidClass 修改为: gValidClassg
define ValidData 修改为: InvalidData
define ValidDict 修改为: zValidDictz
define ValidNum 修改为: InvalidVoice
define ValidStr 修改为: wValidStrw
define WD_NavBarHeight 修改为: hWD_NavBarHeighth
define WD_StatusBarHeight 修改为: pWD_StatusBarHeightp
define WD_TabBarHeight 修改为: aWD_TabBarHeighta
define WD_TopHeight 修改为: aWD_TopHeighta
define baseUrl 修改为: wBaseUrlw
define kAppDelegate 修改为: kKAppDelegatek
define kAppWindow 修改为: sKAppWindows
define kApplication 修改为: jKApplicationj
define kDISPATCH_ASYNC_BLOCK 修改为: gKDISPATCH_ASYNC_BLOCKg
define kDISPATCH_MAIN_BLOCK 修改为: hKDISPATCH_MAIN_BLOCKh
define kDISPATCH_ONCE_BLOCK 修改为: kiBSlayFormerlyHinder
define kEndTime 修改为: dKEndTimed
define kMainColor 修改为: yardMainColor
define kNotificationCenter 修改为: zKNotificationCenterz
define kRandomColor 修改为: bKRandomColorb
define kRealValue 修改为: yKRealValuey
define kRootViewController 修改为: kelvinAncestorProspectController
define kScreen_Bounds 修改为: MScreenSaltation
define kStartTime 修改为: hKStartTimeh
define kStringFormat 修改为: KDrawstringInitialize
define kStrongSelf 修改为: gKStrongSelfg
define kTopHeight 修改为: vKTopHeightv
define kUserDefaults 修改为: MExploiterNonremittal
define kWeakSelf 修改为: jKWeakSelfj
imageset 501 修改为: twist23
imageset 502 修改为: z502z
imageset 503 修改为: v503v
imageset 504 修改为: j504j
imageset 505 修改为: i505i
imageset 506 修改为: a506a
imageset 507 修改为: j507j
imageset 508 修改为: j508j
imageset 509 修改为: v509v
imageset birthdayDataStr 修改为: yBirthdayDataStry
imageset chooseOne 修改为: wChooseOnew
imageset chooseOne1 修改为: jChooseOne1j
imageset find_sel 修改为: cFind_selc
imageset headImg 修改为: headlandCounter
imageset home 修改为: tHomet
imageset homeBG 修改为: hHomeBGh
imageset home_sel 修改为: vHome_selv
imageset mainBgView 修改为: masterYetVista
imageset manIcon 修改为: mankindPicture
imageset manIcon_sel 修改为: dManIcon_seld
imageset mine 修改为: eSoe
imageset mine_sel 修改为: decompressedPlug
imageset mingziStr 修改为: providedRf
imageset oneChoose 修改为: jOneChoosej
imageset oneChoose_sel 修改为: iOneChoose_seli
imageset sceBgimage 修改为: xSceBgimagex
imageset secIcon 修改为: mSecIconm
imageset secIcon_sel 修改为: pSecIcon_selp
imageset womanIcon 修改为: uWomanIconu
imageset womanIcon_sec 修改为: eWomanIcon_sece
imageset xingStr 修改为: oXingStro
protocol CQScrollMenuViewDelegate 修改为: rCQScrollMenuViewDelegater
protocol LZHPersonalCenterViewDelegate 修改为: DevelopmentImpersonalKernelWatchDesignate
static onceToken 修改为: xOnceTokenx
static reuseCellID 修改为: pReuseCellIDp
static reuseHeaderID 修改为: fReuseHeaderIDf
分类方法 baseset 修改为: zPaymentz
分类方法 centerY 修改为: tCenterYt
分类方法 maxY 修改为: zMaxYz
分类方法 minX 修改为: minuteAdam
分类方法 setMaxX 修改为: setTMaxXt
分类方法 setMinY 修改为: setBMinYb
头文件pch PrefixHeader 修改为: gPrefixHeaderg
属性 CenterArr 修改为: pCenterArrp
属性 MUid 修改为: mMUidm
属性 MingStr 修改为: MingDynastyStylistic
属性 NameArray 修改为: NameRegalia
属性 PlaceholderText 修改为: lPlaceholderTextl
属性 Wugexijie 修改为: gWugexijieg
属性 bazi_guanjainzi 修改为: atomMongolian
属性 bazi_id 修改为: lBazi_idl
属性 bazi_jiexi 修改为: baziSailing
属性 bazixishen 修改为: dBazixishend
属性 bottomLinkLong 修改为: rumpYokeHanker
属性 bottomLinkView 修改为: lBottomLinkViewl
属性 carViewLayout 修改为: aCarViewLayouta
属性 centerNS 修改为: kCenterNSk
属性 currentButtonIndex 修改为: eCurrentButtonIndexe
属性 dateStr 修改为: dateColleague
属性 extendCenterRightArr 修改为: expandHalfwayProperlyCapabilities
属性 extendCenterRightNS 修改为: broadenHalfwayFlopNorth
属性 firstname 修改为: qFirstnameq
属性 hasKefu 修改为: sHasKefus
属性 headerImage 修改为: gHeaderImageg
属性 headerView 修改为: copingPurview
属性 imageUrl 修改为: gImageUrlg
属性 inputText 修改为: zInputTextz
属性 isShowHeader 修改为: followUsherHeader
属性 itemHeight 修改为: hItemHeighth
属性 jiMing 修改为: lJiMingl
属性 jiexiLabel 修改为: zJiexiLabelz
属性 label1 修改为: xLabel1x
属性 label2 修改为: nLabel2n
属性 label3 修改为: bLabel3b
属性 lastDirectionIndex 修改为: eLastDirectionIndexe
属性 lastIndexOne 修改为: xLastIndexOnex
属性 lastView 修改为: bLastViewb
属性 lasttimePoint 修改为: cLasttimePointc
属性 leftImg 修改为: fLeftImgf
属性 lineView 修改为: uLineViewu
属性 menuButtonClickedDelegate 修改为: fareUnbuttonChatterDelegate
属性 menuView 修改为: yMenuViewy
属性 mingzi 修改为: plate
属性 nameLabel 修改为: lNameLabell
属性 nameStr 修改为: tNameStrt
属性 name_type 修改为: describeTypewrite
属性 namemodel 修改为: nNamemodeln
属性 nametype 修改为: vNametypev
属性 newsId 修改为: oNewsIdo
属性 pinYin 修改为: oarlockYin
属性 pingfen 修改为: rPingfenr
属性 pinyinStr 修改为: tPinyinStrt
属性 resultString 修改为: terminationTrain
属性 rightExtendLabel 修改为: sRightExtendLabels
属性 rightImg 修改为: xRightImgx
属性 sancaiMutArr 修改为: kSancaiMutArrk
属性 sexSeclectVIew 修改为: fSexSeclectVIewf
属性 sextype 修改为: zSextypez
属性 sharedLinks 修改为: cSharedLinksc
属性 shengxiao 修改为: hShengxiaoh
属性 shengxiaoJY 修改为: strictExclusion
属性 shengxiaoYY 修改为: gShengxiaoYYg
属性 slidDistance 修改为: slewDistance
属性 tabBarAppearance 修改为: pTabBarAppearancep
属性 text1 修改为: textbook171
属性 text10 修改为: uText10u
属性 text2 修改为: tText2t
属性 text3 修改为: dText3d
属性 text4 修改为: schoolText198
属性 text5 修改为: uText5u
属性 text6 修改为: aText6a
属性 text7 修改为: nText7n
属性 text8 修改为: jText8j
属性 text9 修改为: aText9a
属性 textFieldFrame 修改为: zTextFieldFramez
属性 textfile 修改为: serbian
属性 textfile1 修改为: hTextfile1h
属性 textfile2 修改为: jTextfile2j
属性 titleArray 修改为: sTitleArrays
属性 titleStr 修改为: gTitleStrg
属性 viewSize 修改为: dViewSized
属性 viewWidth 修改为: hViewWidthh
属性 visibleCount 修改为: xVisibleCountx
属性 wuXing 修改为: cWuXingc
属性 wuxingStr 修改为: cWuxingStrc
属性 xing 修改为: iInvitei
属性 xingStr 修改为: oXingStro
属性 ziyi 修改为: pZiyip
文件夹修改 501.imageset 修改为: twist23.imageset
文件夹修改 502.imageset 修改为: z502z.imageset
文件夹修改 503.imageset 修改为: v503v.imageset
文件夹修改 504.imageset 修改为: j504j.imageset
文件夹修改 505.imageset 修改为: i505i.imageset
文件夹修改 506.imageset 修改为: a506a.imageset
文件夹修改 507.imageset 修改为: j507j.imageset
文件夹修改 508.imageset 修改为: j508j.imageset
文件夹修改 509.imageset 修改为: v509v.imageset
文件夹修改 AccentColor.colorset 修改为: eAccentColore.colorset
文件夹修改 LZHPersonalCenterView 修改为: zLZHPersonalCenterViewz
文件夹修改 MuGetBaBayNameTests 修改为: dMuGetBaBayNameTestsd
文件夹修改 MuGetBaBayNameUITests 修改为: zMuGetBaBayNameUITestsz
文件夹修改 ZXTextField 修改为: LinkTextbookTheatre
文件夹修改 birthdayDataStr.imageset 修改为: yBirthdayDataStry.imageset
文件夹修改 chooseOne.imageset 修改为: wChooseOnew.imageset
文件夹修改 chooseOne1.imageset 修改为: jChooseOne1j.imageset
文件夹修改 find_sel.imageset 修改为: cFind_selc.imageset
文件夹修改 headImg.imageset 修改为: headlandCounter.imageset
文件夹修改 home.imageset 修改为: tHomet.imageset
文件夹修改 homeBG.imageset 修改为: hHomeBGh.imageset
文件夹修改 home_sel.imageset 修改为: vHome_selv.imageset
文件夹修改 mainBgView.imageset 修改为: masterYetVista.imageset
文件夹修改 manIcon.imageset 修改为: mankindPicture.imageset
文件夹修改 manIcon_sel.imageset 修改为: dManIcon_seld.imageset
文件夹修改 mine.imageset 修改为: eSoe.imageset
文件夹修改 mine_sel.imageset 修改为: decompressedPlug.imageset
文件夹修改 mingziStr.imageset 修改为: providedRf.imageset
文件夹修改 oneChoose.imageset 修改为: jOneChoosej.imageset
文件夹修改 oneChoose_sel.imageset 修改为: iOneChoose_seli.imageset
文件夹修改 sceBgimage.imageset 修改为: xSceBgimagex.imageset
文件夹修改 secIcon.imageset 修改为: mSecIconm.imageset
文件夹修改 secIcon_sel.imageset 修改为: pSecIcon_selp.imageset
文件夹修改 womanIcon.imageset 修改为: uWomanIconu.imageset
文件夹修改 womanIcon_sec.imageset 修改为: eWomanIcon_sece.imageset
文件夹修改 xingStr.imageset 修改为: oXingStro.imageset
方法 ButtonClicked 修改为: fButtonClickedf
方法 CreatData 修改为: vCreatDatav
方法 CreatDetailUI 修改为: fCreatDetailUIf
方法 MudataButtonClicked 修改为: uMudataButtonClickedu
方法 addBeginAnimationWithLabel 修改为: tallyBeginSpiritednessAppropriateTag
方法 addEndAnimationWithLabel 修改为: pAddEndAnimationWithLabelp
方法 animationWithIndex 修改为: jAnimationWithIndexj
方法 confirmBtnClicked 修改为: uConfirmBtnClickedu
方法 creatDate 修改为: itemsEscort
方法 creatGudingUI 修改为: hCreatGudingUIh
方法 creatMoreSexBtn 修改为: jCreatMoreSexBtnj
方法 creatNameListNetWorking 修改为: tCreatNameListNetWorkingt
方法 creatUI 修改为: ditherSpecify
方法 createMoreBtn 修改为: produceFewerPasteboard
方法 dataButtonClicked 修改为: iDataButtonClickedi
方法 deselectAllButtons 修改为: rDeselectAllButtonsr
方法 didClickPublishBtn 修改为: fDidClickPublishBtnf
方法 didSelectRowTitle 修改为: mDidSelectRowTitlem
方法 distinct 修改为: lDistinctl
方法 firstHeaderView 修改为: initialiatoryHeadPosition
方法 getCacheSize 修改为: getMCacheSizem
方法 getIDFA 修改为: getNIDFAn
方法 getNetWorking 修改为: getMeshingWork
方法 getRandomNumber 修改为: getRandomList
方法 goDetailController 修改为: workContingentAccountant
方法 intHeaderView 修改为: iIntHeaderViewi
方法 jiexiNameWithName 修改为: wJiexiNameWithNamew
方法 judgeDirection 修改为: wJudgeDirectionw
方法 makeWithFrame 修改为: aMakeWithFramea
方法 makesureBtnClicked 修改为: dashesEncounteredPenetrate
方法 menuButtonClicked 修改为: menuReleaseDawn
方法 onRadioButtonValueChanged1 修改为: eOnRadioButtonValueChanged1e
方法 onRadioButtonValueChanged2 修改为: oOnRadioButtonValueChanged2o
方法 onTouchUpInside 修改为: uOnTouchUpInsideu
方法 scrollMenuView 修改为: coilFareHorizon
方法 selectedButton 修改为: lSelectedButtonl
方法 sendControlEvent 修改为: tSendControlEventt
方法 setArrayData 修改为: setXArrayDatax
方法 setArraypinyin 修改为: setKArraypinyink
方法 setButtonSelected 修改为: setButtonUnselected
方法 setChildVC 修改为: setCChildVCc
方法 setGroupButtons 修改为: setXGroupButtonsx
方法 setSelectedWithTag 修改为: setOSelectedWithTago
方法 setSlideEnd 修改为: setVSlideEndv
方法 setUpChildVC 修改为: setCUpChildVCc
方法 superScrollView 修改为: dSuperScrollViewd
方法 tapHeader 修改为: mTapHeaderm
方法 tapHeaderClick 修改为: dTapHeaderClickd
方法 testVoid 修改为: screenAnnul
方法 textBeginEditing 修改为: textualMatterEndRedact
方法 textEndEditing 修改为: fTextEndEditingf
方法 withIcon 修改为: sWithIcons
方法 withIndex 修改为: wWithIndexw
方法 withPlaceholderText 修改为: kWithPlaceholderTextk
方法 withRange 修改为: xWithRangex
方法 wuxing 修改为: qWuxingq
类名 AppDelegate 修改为: wAppDelegatew
类名 CQScrollMenuView 修改为: aCQScrollMenuViewa
类名 LZHHeaderView 修改为: DesktopLintelPerspective
类名 LZHPersonalCenterCell 修改为: yLZHPersonalCenterCelly
类名 LZHPersonalCenterView 修改为: zLZHPersonalCenterViewz
类名 MUBaseViewController 修改为: xMUBaseViewControllerx
类名 MUDetailViewController 修改为: kMUDetailViewControllerk
类名 MUHomeViewController 修改为: aMUHomeViewControllera
类名 MUMineDetailVC 修改为: gMUMineDetailVCg
类名 MUMineViewController 修改为: vMUMineViewControllerv
类名 MUNameListVC 修改为: bMUNameListVCb
类名 MUNameModel 修改为: ShutterCallPose
类名 MUSecViewController 修改为: PanoramaSecantPerspectiveController
类名 MUTabbar 修改为: BarrierSource
类名 MUTabbarVC 修改为: dMUTabbarVCd
类名 RadioButton 修改为: tRadioButtont
类名 ZXTextField 修改为: LinkTextbookTheatre
类名 ZYCarCollectionViewCell 修改为: mZYCarCollectionViewCellm
类名 ZYCarModel 修改为: eZYCarModele
类名 ZYCarView 修改为: nZYCarViewn
类名 ZYCarViewLayout 修改为: rZYCarViewLayoutr
类名修改 MuGetBaBayNameTests 修改为: dMuGetBaBayNameTestsd
类名修改 MuGetBaBayNameUITests 修改为: zMuGetBaBayNameUITestsz
系统分类 UIView+FrameTool 修改为: UIView+jFormToolj
自定义分类 AppDelegate+Setting 修改为: wAppDelegatew+lSettingl
资源:jpg headImg 修改为: headlandCounter
资源:png birthdayDataStr 修改为: yBirthdayDataStry
资源:png chooseOne 修改为: wChooseOnew
资源:png chooseOne1 修改为: jChooseOne1j
资源:png find_sel 修改为: cFind_selc
资源:png home 修改为: tHomet
资源:png home_sel 修改为: vHome_selv
资源:png manIcon 修改为: mankindPicture
资源:png manIcon_sel 修改为: dManIcon_seld
资源:png mine 修改为: eSoe
资源:png mine_sel 修改为: decompressedPlug
资源:png mingziStr 修改为: providedRf
资源:png oneChoose 修改为: jOneChoosej
资源:png oneChoose_sel 修改为: iOneChoose_seli
资源:png secIcon 修改为: mSecIconm
资源:png secIcon_sel 修改为: pSecIcon_selp
资源:png womanIcon 修改为: uWomanIconu
资源:png womanIcon_sec 修改为: eWomanIcon_sece
资源:png xingStr 修改为: oXingStro
资源:xib LZHHeaderView 修改为: DesktopLintelPerspective
资源:xib ZYCarCollectionViewCell 修改为: mZYCarCollectionViewCellm
